0 0 0 0 0 0 0 0 0 0 0 0 0 0 0 0 0 0 0 0 0 0 0 0 0 0 0 0 0 0 
0 0 0 0 0 0 0 0 0 0 0 0 0 0 0 0 0 0 0 0 0 0 0 0 0 0 0 0 0 0 
3 3 0 0 0 0 0 0 0 0 0 0 0 0 0 0 0 0 0 0 0 0 0 0 0 0 0 0 0 0 
5 5 3 3 0 0 0 0 0 0 0 0 0 0 0 0 0 0 0 0 0 0 0 0 0 0 0 0 0 0 
5 5 5 5 3 0 0 0 0 0 0 0 0 0 0 0 0 0 0 0 0 0 0 0 0 0 0 0 0 0 
5 5 5 5 5 3 3 0 0 0 0 0 0 0 0 0 0 0 0 0 0 0 0 0 0 0 0 0 0 3 
5 5 5 5 5 5 5 3 0 0 0 0 0 0 0 0 0 0 0 0 0 0 0 0 0 0 0 0 3 3 
5 5 5 5 5 5 5 5 3 3 0 0 0 0 0 0 0 0 0 2 2 2 1 1 1 1 2 2 2 0 
2 2 2 2 2 2 2 2 2 2 2 2 2 2 2 2 2 2 2 2 2 1 1 1 1 1 1 2 2 2 
4 4 0 0 0 0 0 4 4 0 1 1 0 0 4 4 4 3 3 0 4 4 4 0 0 0 0 0 0 0 
4 4 0 0 0 0 0 4 4 0 1 1 0 0 4 4 4 3 3 0 4 4 4 0 0 0 0 3 3 0 
0 0 0 0 0 0 0 0 0 0 1 1 0 0 4 4 4 3 3 0 4 4 4 0 0 0 0 3 3 0 
0 3 3 0 4 4 0 0 0 0 0 0 0 0 0 0 0 0 0 0 0 0 0 0 0 0 0 0 0 0 
0 3 3 0 4 4 0 0 0 0 0 0 0 0 0 0 0 4 4 4 0 0 0 0 4 4 0 0 0 2 
0 0 0 0 0 0 0 0 0 4 4 4 0 0 0 0 0 4 4 4 0 0 0 0 4 4 0 0 2 2 
0 0 4 4 0 0 0 0 0 4 4 4 0 4 4 0 0 4 4 4 1 1 1 0 0 0 0 2 2 5 
0 0 4 4 0 0 3 3 0 4 4 4 0 4 4 0 0 0 0 0 1 1 1 0 0 0 2 5 5 5 
0 0 0 0 0 0 3 3 0 0 0 0 0 0 0 0 0 0 0 0 1 1 1 0 0 2 2 5 5 5 
2 2 2 1 1 1 1 1 1 2 2 2 2 2 2 2 2 2 2 2 2 2 2 2 2 2 5 5 5 5 
5 2 2 1 1 1 1 1 1 2 2 5 5 5 5 5 5 5 5 5 5 5 5 5 5 5 5 5 5 5 
5 5 2 0 0 0 0 0 0 2 5 5 5 5 5 5 5 5 5 5 5 5 5 5 5 5 5 5 5 5 
5 5 5 2 0 0 0 0 0 3 3 3 3 3 3 3 3 3 5 5 5 5 5 5 5 5 5 5 5 5 
5 5 5 3 0 0 0 0 0 0 0 0 0 0 0 0 3 3 3 5 5 5 5 5 5 5 5 5 5 5 
5 5 5 3 3 3 0 0 0 0 0 0 0 0 0 0 0 3 3 5 5 5 5 5 5 5 5 5 5 5 
5 5 5 3 3 3 3 0 0 0 0 0 0 0 0 0 0 3 3 3 5 5 5 5 5 5 5 5 5 5 
5 5 5 5 5 3 3 3 3 0 0 0 0 0 0 0 0 0 3 3 3 5 5 5 5 5 5 5 5 5 
5 5 5 5 5 5 3 3 3 3 3 0 0 0 0 0 0 0 3 3 3 3 5 5 5 5 5 5 5 5 
5 5 5 5 5 5 5 3 3 3 3 3 0 0 1 1 0 0 3 3 3 5 5 5 5 5 5 5 5 5 
5 5 5 5 5 5 5 5 5 3 0 0 0 1 6 7 1 0 0 0 3 5 5 5 5 5 5 5 5 5 
5 5 5 5 5 5 5 5 5 3 0 0 0 1 8 9 1 0 0 0 3 5 5 5 5 5 5 5 5 5 
